"filename", "language", "Python", "Markdown", "pip requirements", "comment", "blank", "total"
"/Users/admin/src/mcp_safe_local_python_executor/README.md", "Markdown", 0, 36, 0, 0, 16, 52
"/Users/admin/src/mcp_safe_local_python_executor/examples/run_executor.py", "Python", 24, 0, 0, 4, 7, 35
"/Users/admin/src/mcp_safe_local_python_executor/examples/run_mcp_server.py", "Python", 58, 0, 0, 6, 11, 75
"/Users/admin/src/mcp_safe_local_python_executor/examples/test_mcp_client.py", "Python", 81, 0, 0, 14, 19, 114
"/Users/admin/src/mcp_safe_local_python_executor/executor.py", "Python", 486, 0, 0, 1, 51, 538
"/Users/admin/src/mcp_safe_local_python_executor/mcp_server.py", "Python", -3, 0, 0, 9, 3, 9
"/Users/admin/src/mcp_safe_local_python_executor/requirements.txt", "pip requirements", 0, 0, 7, 0, 0, 7
"/Users/admin/src/mcp_safe_local_python_executor/setup.py", "Python", 29, 0, 0, 0, 2, 31
"/Users/admin/src/mcp_safe_local_python_executor/tests/run_executor.py", "Python", -24, 0, 0, -4, -7, -35
"/Users/admin/src/mcp_safe_local_python_executor/tests/test_local_python_executor.py", "Python", -98, 0, 0, -7, -27, -132
"/Users/admin/src/mcp_safe_local_python_executor/tests/test_mcp_server.py", "Python", -13, 0, 0, 4, 1, -8
"Total", "-", 540, 36, 7, 27, 76, 686